{
  "dimensions": [5, 5],
  "limits": {
    "code": 55,
    "compute": 60 
  },
  "rate": 200,
  "start": [4, 0],
  "finish": [4, 4],
  "frames": [
    [[1, 1, 0, 0, 0], [0, 1, 0, 0, 1], [0, 0, 1, 1, 0], [0, 0, 1, 1, 0], [0, 0, 1, 1, 1]],
    [[0, 1, 1, 1, 1], [1, 0, 1, 1, 0], [1, 1, 0, 0, 0], [1, 0, 0, 0, 0], [0, 0, 0, 0, 0]],
    [[0, 1, 1, 0, 1], [1, 1, 1, 0, 1], [0, 1, 0, 0, 1], [1, 0, 0, 0, 1], [1, 0, 0, 0, 0]],
    [[0, 1, 1, 1, 1], [0, 0, 1, 0, 0], [1, 1, 0, 0, 1], [1, 0, 0, 1, 1], [1, 0, 0, 0, 0]],
    [[0, 1, 0, 0, 1], [0, 1, 0, 0, 1], [1, 0, 0, 1, 1], [1, 0, 0, 0, 1], [1, 0, 0, 0, 0]],
    [[0, 0, 0, 1, 1], [1, 1, 1, 1, 1], [1, 1, 0, 0, 0], [1, 0, 0, 0, 0], [0, 0, 0, 0, 0]],
    [[0, 0, 1, 1, 0], [0, 0, 1, 1, 1], [0, 1, 0, 1, 1], [1, 0, 0, 0, 0], [0, 0, 0, 0, 0]],
    [[0, 0, 1, 1, 0], [0, 1, 0, 0, 1], [1, 0, 0, 1, 1], [1, 0, 0, 1, 0], [0, 0, 0, 0, 0]],
    [[1, 1, 1, 0, 0], [0, 0, 0, 1, 1], [1, 1, 0, 0, 0], [1, 0, 0, 1, 0], [0, 0, 0, 0, 0]]
  ]
}
